- - - - - - - - - - - - - - - -
- - - - T T - - - - - - - - - -
- - - U G G I T T - - - - - - -
- - L G G G G G G I - - - - - -
- - L G G G G G G G I T E - - -
- - - J G G G G G G G G R - - -
- - - - B J G G G G G G I - - -
- - - - - - B B J G G G G R - -
- - - - - - - - - B J G G R - -
- - - - - - - - - - - B B D - -
