- - Q T T T T T T T T T T - - -
- - L G G G G G G G G G G R - -
- Q U G G G G G G G G G G R - -
- L G G G G G G K B B B B D - -
- L G G G G G G I T T T E - - -
- - B B J G G G G G G G R - - -
- - Q T U G G G G G G G I - - -
- - L G G G G G G G G G G R - -
- - L G G G G G G G G G G R - -
- - A B B B B B B B B B B D - -